1111111111111111111111111111111111
1P000C000000100C00001C00CC00000001
11101111011000101010110111110111C1
1C1001C10010101000100100000001C111
1C11010110111011000000011111000001
1000000CC000001000111100CCC1000001
11111111111111111110C1011111011111
101100000010000C10001101C10000CCC1
10100101001C10001C1001000101011111
1010110011111110101C0111010101C1C1
1000C100C00C00C0001000C0000000CCC1
1111110001111111111111111111111111
1111110001111111111111111111111111
10000C000000100C00001C00CC00000001
11101111011000101010110111110111C1
1C1001C10010101000100100000001C111
1C11010110111011000000011111000001
1000000CC000001000111100CCC1000001
11111111111111111110C1011111011111
101100000010000C10001101C10000CCC1
10100101001C10001C1001000101011111
1010110011111110101C0111010101C1C1
1000C100C00C00C0001000C0000000CCC1
1111111111111111111100011111111111
1111111111111111111000111111111111
10000C000000100C00001C00CC00000001
11101111011000101010110111110111C1
1C1001C10010101000100100000001C111
1C11010110111011000000011111000001
1000000CC000001000111100CCC1000001
11111111111111111110C1011111011111
101100000010000C10001101C10000CCC1
10100101001C10001C1001000101011111
1010110011111110101C0111010101C1C1
1000C100C00C00C0001000C0000000CCC1
1111111111111111111000000111111111
1111111111111100000000111111111111
10000C000000100C00001C00CC00000001
11101111011000101010110111110111C1
1C1001C10010101000100100000001C111
1C11010110111011000000011111000001
1000000CC000001000111100CCC1000001
11111111111111111110C1011111011111
101100000010000C10001101C10000CCC1
10100101001C10001C1001000101011111
1010110011111110101C0111010101C1C1
1000C100C00C00C0001000C0000000CCC1
1111111111111100000111111111111111
1111111111110001111111111111111111
10000C000000100C00001C00CC00000001
11101111011000101010110111110111C1
1C1001C10010101000100100000001C111
1C11010110111011000000011111000001
1000000CC000001000111100CCC1000001
11111111111111111110C1011111011111
101100000010000C10001101C10000CCC1
10100101001C10001C1001000101011111
1010110011111110101C0111010101C1C1
1000C100C00C00C0001000C0000000CCC1
1111111111111111100001111111111111
1111111111111111111100111111111111
10000C000000100C00001C00CC00000001
11101111011000101010110111110111C1
1C1001C10010101000100100000001C111
1C11010110111011000000011111000001
1000000CC000001000111100CCC1000001
11111111111111111110C1011111011111
1E1100000010000C10001101C10000CCC1
10100101001C10001C1001000101011111
1010110011111110101C0111010101C1C1
1000C100C00C00C0001000C0000000CCC1
1111111111111111111111111111111111
