111111111111111111
10000100C1010000E1
101001011100011111
101100010001000001
1P1C01000101C010E1
111111111111111111
