111111111111111
1C00100010C10E1
101000100011011
101011111000001
1P100C00C001CC1
111111111111111
