111111111111111
1P10100010C10E1
101000100011011
101011111000001
1C000C00C001CC1
111111111111111
